-----------------------------------
|-|-|-|TW|-|-|TL|-|TL|-|-|TW|-|-|-|
-----------------------------------
|-|-|DL|-|-|DW|-|-|-|DW|-|-|DL|-|-|
-----------------------------------
|-|DL|-|-|DL|-|-|-|-|-|DL|-|-|DL|-|
-----------------------------------
|TW|-|-|TL|-|-|-|DW|-|-|-|TL|-|-|TW|
-----------------------------------
|-|-|DL|-|-|-|DL|-|DL|-|-|-|DL|-|-|
-----------------------------------
|-|DW|-|-|-|TL|-|-|-|TL|-|-|-|DW|-|
-----------------------------------
|TL|-|-|-|DL|-|-|-|-|-|DL|-|-|-|TL|
-----------------------------------
|-|-|-|DW|-|-|-|-|-|-|-|DW|-|-|-|
-----------------------------------
|TL|-|-|-|DL|-|-|-|-|-|DL|-|-|-|TL|
-----------------------------------
|-|DW|-|-|-|TL|-|-|-|TL|-|-|-|DW|-|
-----------------------------------
|-|-|DL|-|-|-|DL|-|DL|-|-|-|DL|-|-|
-----------------------------------
|TW|-|-|TL|-|-|-|DW|-|-|-|TL|-|-|TW|
-----------------------------------
|-|DL|-|-|DL|-|-|-|-|-|DL|-|-|DL|-|
-----------------------------------
|-|-|DL|-|-|DW|-|-|-|DW|-|-|DL|-|-|
-----------------------------------
|-|-|-|TW|-|-|TL|-|TL|-|-|TW|-|-|-|
-----------------------------------
15
15
